###################
#A   #     #      #
# ## # ### # #### #
#    #   # #    # #
#### ### # #### # #
#      # #    # # #
# #### # #### # # #
# #  # #    # #   #
# ## # #### # ### #
#    #      #     #
#### ########### ##
#          #      #
# ######## # ######
#        # #     B#
###################
